torch.nn.functional.nll_loss	paddle.nn.functional.nll_loss	1
torch.nn.functional.smooth_l1_loss	paddle.nn.functional.smooth_l1_loss	1
torch.nn.functional.soft_margin_loss	paddle.nn.functional.soft_margin_loss	1
torch.nn.functional.triplet_margin_loss	paddle.nn.functional.triplet_margin_loss	1
torch.nn.functional.triplet_margin_with_distance_loss	paddle.nn.functional.triplet_margin_with_distance_loss	1
torch.nn.functional.pixel_shuffle	paddle.nn.functional.pixel_shuffle	1
torch.nn.functional.pixel_unshuffle	paddle.nn.functional.pixel_unshuffle	1
torch.nn.functional.pad	paddle.nn.functional.pad	1
torch.nn.functional.upsample	paddle.nn.functional.upsample	1
torch.nn.functional.grid_sample	paddle.nn.functional.grid_sample	1
torch.nn.functional.affine_grid	paddle.nn.functional.affine_grid	1
torch.Tensor.device	paddle.Tensor.place	1
torch.Tensor.grad	paddle.Tensor.grad	1
torch.Tensor.ndim	paddle.Tensor.ndim	1
torch.Tensor.shape	paddle.Tensor.shape	1
torch.Tensor.T	paddle.Tensor.T	1
torch.Tensor.real	paddle.Tensor.real	1
torch.Tensor.imag	paddle.Tensor.imag	1
torch.Tensor.is_leaf	paddle.Tensor.is_leaf	1
torch.Tensor.is_sparse	paddle.Tensor.is_sparse	1
torch.Tensor.abs	paddle.Tensor.abs	1
torch.Tensor.absolute	paddle.Tensor.abs	1
torch.Tensor.acos	paddle.Tensor.acos	1
torch.Tensor.arccos	paddle.Tensor.acos	1
torch.Tensor.addmm	paddle.Tensor.addmm	1
torch.Tensor.allclose	paddle.Tensor.allclose	1
torch.Tensor.amax	paddle.Tensor.amax	1
torch.Tensor.amin	paddle.Tensor.amin	1
torch.Tensor.angle	paddle.Tensor.angle	1
torch.Tensor.argmax	paddle.Tensor.argmax	1
torch.Tensor.argmin	paddle.Tensor.argmin	1
torch.Tensor.argsort	paddle.Tensor.argsort	1
torch.Tensor.asin	paddle.Tensor.asin	1
torch.Tensor.arcsin	paddle.Tensor.asin	1
torch.Tensor.atan	paddle.Tensor.atan	1
torch.Tensor.arctan	paddle.Tensor.atan	1
torch.Tensor.atan2	paddle.atan2	1
torch.Tensor.all	paddle.Tensor.all	1
torch.Tensor.any	paddle.Tensor.any	1
torch.Tensor.bincount	paddle.Tensor.bincount	1
torch.Tensor.bitwise_not	paddle.Tensor.bitwise_not	1
torch.Tensor.bitwise_and	paddle.Tensor.bitwise_and	1
torch.Tensor.bitwise_or	paddle.Tensor.bitwise_or	1
torch.Tensor.bitwise_xor	paddle.Tensor.bitwise_xor	1
torch.Tensor.bmm	paddle.Tensor.bmm	1
torch.Tensor.broadcast_to	paddle.Tensor.broadcast_to	1
torch.Tensor.ceil	paddle.Tensor.ceil	1
torch.Tensor.ceil_	paddle.Tensor.ceil_	1
torch.Tensor.cholesky	paddle.Tensor.cholesky	1
torch.Tensor.cholesky_solve	paddle.Tensor.cholesky_solve	1
torch.Tensor.chunk	paddle.Tensor.chunk	1
torch.Tensor.clamp	paddle.Tensor.clip	1
torch.Tensor.clamp_	paddle.Tensor.clip_	1
torch.Tensor.clip	paddle.Tensor.clip	1
torch.Tensor.clip_	paddle.Tensor.clip_	1
torch.Tensor.conj	paddle.Tensor.conj	1
torch.Tensor.cos	paddle.Tensor.cos	1
torch.Tensor.cosh	paddle.Tensor.cosh	1
torch.Tensor.count_nonzero	paddle.count_nonzero	1
torch.Tensor.acosh	paddle.Tensor.acosh	1
torch.Tensor.arccosh	paddle.Tensor.acosh	1
torch.Tensor.cpu	paddle.Tensor.cpu	1
torch.Tensor.cross	paddle.Tensor.cross	1
torch.Tensor.logcumsumexp	paddle.Tensor.logcumsumexp	1
torch.Tensor.cumprod	paddle.Tensor.cumprod	1
torch.Tensor.cumsum	paddle.Tensor.cumsum	1
torch.Tensor.deg2rad	paddle.Tensor.deg2rad	1
torch.Tensor.det	paddle.linalg.det(x)	1
torch.Tensor.detach	paddle.Tensor.detach	1
torch.Tensor.diag	paddle.diag	1
torch.Tensor.diagflat	paddle.diagflat	1
torch.Tensor.diagonal	paddle.Tensor.diagonal	1
torch.Tensor.fill_diagonal_	paddle.Tensor.fill_diagonal_	1
torch.Tensor.fmax	paddle.Tensor.fmax	1
torch.Tensor.fmin	paddle.Tensor.fmin	1
torch.Tensor.diff	paddle.Tensor.diff	1
torch.Tensor.digamma	paddle.Tensor.digamma	1
torch.Tensor.dim	paddle.Tensor.dim	1
torch.Tensor.dist	paddle.Tensor.dist	1
torch.Tensor.dot	paddle.Tensor.dot	1
torch.Tensor.element_size	paddle.Tensor.element_size	1
torch.Tensor.eq	paddle.Tensor.equal	1
torch.Tensor.equal	paddle.Tensor.equal_all	1
torch.Tensor.erf	paddle.Tensor.erf	1
torch.Tensor.erfinv	paddle.Tensor.erfinv	1
torch.Tensor.erfinv_	paddle.Tensor.erfinv_	1
torch.Tensor.exp	paddle.Tensor.exp	1
torch.Tensor.exp_	paddle.Tensor.exp_	1
torch.Tensor.expand_as	paddle.Tensor.expand_as	1
torch.Tensor.fix	paddle.Tensor.trunc	1
torch.Tensor.fill_	paddle.Tensor.fill_	1
torch.Tensor.flatten	paddle.Tensor.flatten	1
torch.Tensor.flip	paddle.Tensor.flip	1
torch.Tensor.fliplr	paddle.Tensor.flip	1
torch.Tensor.flipud	paddle.Tensor.flip	1
torch.Tensor.floor	paddle.Tensor.floor	1
torch.Tensor.floor_	paddle.Tensor.floor_	1
torch.Tensor.floor_divide	paddle.Tensor.floor_divide	1
torch.Tensor.frac	paddle.Tensor.frac	1
torch.Tensor.gather	paddle.Tensor.take_along_axis	1
torch.Tensor.gcd	paddle.Tensor.gcd	1
torch.Tensor.ge	paddle.Tensor.greater_equal	1
torch.Tensor.greater_equal	paddle.Tensor.greater_equal	1
torch.Tensor.ger	paddle.Tensor.outer	1
torch.Tensor.get_device	paddle.device.get_device	1
torch.Tensor.gt	paddle.Tensor.greater_than	1
torch.Tensor.greater	paddle.Tensor.greater_than	1
torch.Tensor.hardshrink	paddle.nn.functional.hardshrink	1
torch.Tensor.heaviside	paddle.Tensor.heaviside	1
torch.Tensor.histc	paddle.Tensor.histogram	1
torch.Tensor.index_copy	paddle.Tensor.scatter	1
torch.Tensor.index_select	paddle.Tensor.index_select	1
torch.Tensor.indices	paddle.Tensor.indices	1
torch.Tensor.values	paddle.Tensor.values	1
torch.Tensor.inner	paddle.Tensor.inner	1
torch.Tensor.inverse	paddle.Tensor.inverse	1
torch.Tensor.isclose	paddle.Tensor.isclose	1
torch.Tensor.isfinite	paddle.Tensor.isfinite	1
torch.Tensor.isinf	paddle.Tensor.isinf	1
torch.Tensor.isnan	paddle.Tensor.isnan	1
torch.Tensor.is_complex	paddle.Tensor.is_complex	1
torch.Tensor.is_floating_point	paddle.Tensor.is_floating_point	1
torch.Tensor.istft	paddle.signal.istft	1
torch.Tensor.item	paddle.Tensor.item	1
torch.Tensor.kthvalue	paddle.Tensor.kthvalue	1
torch.Tensor.lcm	paddle.Tensor.lcm	1
torch.Tensor.le	paddle.Tensor.less_equal	1
torch.Tensor.less_equal	paddle.Tensor.less_equal	1
torch.Tensor.lerp	paddle.Tensor.lerp	1
torch.Tensor.lerp_	paddle.Tensor.lerp_	1
torch.Tensor.lgamma	paddle.Tensor.lgamma	1
torch.Tensor.log	paddle.Tensor.log	1
torch.Tensor.logdet	paddle.linalg.slogdet(x)	1
torch.Tensor.log10	paddle.Tensor.log10	1
torch.Tensor.log1p	paddle.Tensor.log1p	1
torch.Tensor.log2	paddle.Tensor.log2	1
torch.Tensor.logsumexp	paddle.Tensor.logsumexp	1
torch.Tensor.logical_and	paddle.Tensor.logical_and	1
torch.Tensor.logical_not	paddle.Tensor.logical_not	1
torch.Tensor.logical_or	paddle.Tensor.logical_or	1
torch.Tensor.logical_xor	paddle.Tensor.logical_xor	1
torch.Tensor.logit	paddle.Tensor.logit	1
torch.Tensor.lstsq	paddle.Tensor.lstsq	1
torch.Tensor.lt	paddle.Tensor.less_than	1
torch.Tensor.less	paddle.Tensor.less_than	1
torch.Tensor.lu	paddle.Tensor.lu	1
torch.Tensor.masked_select	paddle.Tensor.masked_select	1
torch.Tensor.matmul	paddle.Tensor.matmul	1
torch.Tensor.matrix_power	paddle.Tensor.matrix_power	1
torch.Tensor.max	paddle.Tensor.max	1
torch.Tensor.maximum	paddle.Tensor.maximum	1
torch.Tensor.mean	paddle.Tensor.mean	1
torch.Tensor.median	paddle.Tensor.median	1
torch.Tensor.nanmedian	paddle.Tensor.nanmedian	1
torch.Tensor.min	paddle.Tensor.min	1
torch.Tensor.minimum	paddle.Tensor.minimum	1
torch.Tensor.mm	paddle.Tensor.mm	1
torch.Tensor.mode	paddle.Tensor.mode	1
torch.Tensor.movedim	paddle.Tensor.moveaxis	1
torch.Tensor.moveaxis	paddle.Tensor.moveaxis	1
torch.Tensor.mul	paddle.Tensor.multiply	1
torch.Tensor.mul_	paddle.Tensor.scale_	1
torch.Tensor.multiply	paddle.Tensor.multiply	1
torch.Tensor.multiply_	paddle.Tensor.scale_	1
torch.Tensor.mv	paddle.Tensor.mv	1
torch.Tensor.nansum	paddle.Tensor.nansum	1
torch.Tensor.ndimension	paddle.Tensor.ndimension	1
torch.Tensor.ne	paddle.Tensor.not_equal	1
torch.Tensor.not_equal	paddle.Tensor.not_equal	1
torch.Tensor.neg	paddle.Tensor.neg	1
torch.Tensor.negative	paddle.Tensor.neg	1
torch.Tensor.nelement	paddle.Tensor.size	1
torch.Tensor.nonzero	paddle.Tensor.nonzero	1
torch.Tensor.numel	paddle.Tensor.size	1
torch.Tensor.numpy	paddle.Tensor.numpy	1
torch.Tensor.outer	paddle.Tensor.outer	1
torch.Tensor.pin_memory	paddle.Tensor.pin_memory	1
torch.Tensor.pow	paddle.Tensor.pow	1
torch.Tensor.prod	paddle.Tensor.prod	1
torch.Tensor.nanquantile	paddle.Tensor.nanquantile	1
torch.Tensor.rad2deg	paddle.Tensor.rad2deg	1
torch.Tensor.reciprocal	paddle.Tensor.reciprocal	1
torch.Tensor.reciprocal_	paddle.Tensor.reciprocal_	1
torch.Tensor.register_hook	paddle.Tensor.register_hook	1
torch.Tensor.remainder	paddle.Tensor.remainder	1
torch.Tensor.remainder_	paddle.Tensor.remainder_	1
torch.Tensor.renorm	paddle.Tensor.renorm	1
torch.Tensor.retain_grad	paddle.Tensor.retain_grad	1
torch.Tensor.roll	paddle.Tensor.roll	1
torch.Tensor.rot90	paddle.Tensor.rot90	1
torch.Tensor.rsqrt	paddle.Tensor.rsqrt	1
torch.Tensor.rsqrt_	paddle.Tensor.rsqrt_	1
torch.Tensor.select	paddle.index_select	1
torch.Tensor.sigmoid	paddle.Tensor.sigmoid	1
torch.Tensor.sign	paddle.Tensor.sign	1
torch.Tensor.sin	paddle.Tensor.sin	1
torch.Tensor.sinh	paddle.Tensor.sinh	1
torch.Tensor.asinh	paddle.Tensor.asinh	1
torch.Tensor.arcsinh	paddle.Tensor.asinh	1
torch.Tensor.slogdet	paddle.Tensor.slogdet	1
torch.Tensor.sort	paddle.Tensor.sort	1
torch.Tensor.sparse_dim	paddle.Tensor.sparse_dim	1
torch.Tensor.sqrt	paddle.Tensor.sqrt	1
torch.Tensor.sqrt_	paddle.Tensor.sqrt_	1
torch.Tensor.square	paddle.Tensor.square	1
torch.Tensor.squeeze	paddle.Tensor.squeeze	1
torch.Tensor.squeeze_	paddle.Tensor.squeeze_	1
torch.Tensor.std	paddle.Tensor.std	1
torch.Tensor.sum	paddle.Tensor.sum	1
torch.Tensor.t	paddle.Tensor.t	1
torch.Tensor.tile	paddle.Tensor.tile	1
torch.Tensor.take	paddle.Tensor.take	1
torch.Tensor.tan	paddle.Tensor.tan	1
torch.Tensor.tanh	paddle.Tensor.tanh	1
torch.Tensor.tanh_	paddle.Tensor.tanh_	1
torch.Tensor.atanh	paddle.Tensor.atanh	1
torch.Tensor.arctanh	paddle.Tensor.atanh	1
torch.Tensor.tolist	paddle.Tensor.tolist	1
torch.Tensor.topk	paddle.Tensor.topk	1
torch.Tensor.to_sparse	paddle.Tensor.to_sparse_coo	1
torch.Tensor.trace	paddle.Tensor.trace	1
torch.Tensor.tril	paddle.Tensor.tril	1
torch.Tensor.triu	paddle.Tensor.triu	1
torch.Tensor.true_divide	paddle.Tensor.divide	1
torch.Tensor.trunc	paddle.Tensor.trunc	1
torch.Tensor.unbind	paddle.Tensor.unbind	1
torch.Tensor.uniform_	paddle.Tensor.uniform_	1
torch.Tensor.unique_consecutive	paddle.Tensor.unique_consecutive	1
torch.Tensor.unsqueeze	paddle.Tensor.unsqueeze	1
torch.Tensor.unsqueeze_	paddle.Tensor.unsqueeze_	1
torch.Tensor.var	paddle.Tensor.var	1
torch.Tensor.where	paddle.Tensor.where	1
torch.Tensor.zero_	paddle.Tensor.zero_	1
torch.cuda.Event	paddle.device.cuda.Event	1
torch.cuda.current_device	paddle.framework._current_expected_place	1
torch.cuda.current_stream	paddle.device.cuda.current_stream	1
torch.cuda.device_count	paddle.device.cuda.device_count	1
torch.cuda.get_device_capability	paddle.device.cuda.get_device_capability	1
torch.cuda.get_device_properties	paddle.device.cuda.get_device_properties	1
torch.cuda.set_device	paddle.device.set_device	1
torch.cuda.synchronize	paddle.device.cuda.synchronize	1
torch.cuda.manual_seed	paddle.seed	1
torch.cuda.empty_cache	paddle.device.cuda.empty_cache	1
torch.cuda.memory_allocated	paddle.device.cuda.memory_allocated	1
torch.cuda.max_memory_allocated	paddle.device.cuda.max_memory_allocated	1
torch.cuda.memory_reserved	paddle.device.cuda.memory_reserved	1
torch.cuda.max_memory_reserved	paddle.device.cuda.max_memory_reserved	1
torch.backends.cudnn.version		1
torch.distributed.ReduceOp	paddle.distributed.ReduceOp	1
torch.distributions.kl.kl_divergence	paddle.distribution.kl_divergence	1
torch.distributions.kl.register_kl	paddle.distribution.register_kl	1
torch.fft.fftshift	paddle.fft.fftshift	1
torch.fft.ifftshift	paddle.fft.ifftshift	1
torch.linalg.svd	paddle.linalg.svd	1
torch.nn.init.calculate_gain	paddle.nn.initializer.calculate_gain	1
torch.random.manual_seed	paddle.seed	1
torch.sparse.sum	paddle.sparse.sum	1
torch.sparse.addmm	paddle.sparse.addmm	1
torch.sparse.mm	paddle.sparse.matmul	1
torch.sparse.softmax	paddle.sparse.softmax	1
torch.utils.cpp_extension.CppExtension	paddle.utils.cpp_extension.CppExtension	1
torch.utils.cpp_extension.CUDAExtension	paddle.utils.cpp_extension.CUDAExtension	1
torch.utils.cpp_extension.load	paddle.utils.cpp_extension.load	1
torch.utils.data.random_split	paddle.io.random_split	1
torch.utils.dlpack.from_dlpack	paddle.utils.dlpack.from_dlpack	1
torch.utils.dlpack.to_dlpack	paddle.utils.dlpack.to_dlpack	1
torch.Tensor.take_along_dim	paddle.Tensor.take_along_axis	1
torch.linalg.matrix_power	paddle.linalg.matrix_power	1
torch.dsplit	paddle.split	1
torch.special.expm1	paddle.expm1	1
torch.Tensor.coalesce	paddle.Tensor.coalesce	1
torch.nn.HuberLoss	paddle.nn.SmoothL1Loss	1
torch.special.erfinv	paddle.erfinv	1
torch.special.logit	paddle.logit	1
torch.vsplit	paddle.split	1
torch.hsplit	paddle.split	1
torch.Tensor.is_coalesced	paddle.Tensor.is_coalesced	1
torch.is_grad_enabled	paddle.is_grad_enabled	1
torch.Tensor.hsplit	paddle.Tensor.split	1
torch.Tensor.vsplit	paddle.Tensor.split	1
torch.nn.functional.huber_loss	paddle.nn.functional.smooth_l1_loss	1
torch.Tensor.to_dense	paddle.Tensor.to_dense	1
torch.Tensor.frexp	paddle.Tensor.frexp	1
torch.cuda.set_stream	paddle.device.set_stream	1
torch.Tensor.dsplit	paddle.Tensor.split	1
torch.cov	paddle.linalg.cov	1
torch.Tensor.corrcoef	paddle.Tensor.corrcoef	1
torch.corrcoef	paddle.linalg.corrcoef	1
torch.Tensor.cov	paddle.Tensor.cov	1
torch.permute	paddle.transpose	1
torch.asarray	paddle.to_tensor	1
torch.argwhere	paddle.nonzero	1
torch.select	paddle.index_select	1
torch.autograd.Function.jvp	paddle.incubate.autograd.jvp	1
torch.linalg.diagonal	paddle.diagonal	1
torch.special.softmax	paddle.nn.functional.softmax	1
torch.from_dlpack	paddle.utils.dlpack.from_dlpack	1
torch.index_copy	paddle.scatter	1
torch.nn.Dropout1d	paddle.nn.Dropout2D	1
torch.nn.functional.dropout1d	paddle.nn.functional.dropout	1
torch.Tensor.softmax	paddle.nn.functional.softmax	1
torch.optim.Optimizer.state_dict	paddle.optimizer.Optimizer.state_dict	1
torch.optim.Optimizer.load_state_dict	paddle.optimzier.Optimizer.set_state_dict	1
torch.nn.ModuleList	paddle.nn.LayerList	1
torch.nn.ModuleDict	paddle.nn.LayerDict	1
torch.nn.Module	paddle.nn.Layer	1
torch.nn.Module.add_module	paddle.nn.Layer.add_sublayer	1
torch.nn.Module.apply	paddle.nn.Layer.apply	1
torch.set_printoptions	paddle.set_printoptions	2
torch.sparse_coo_tensor	paddle.incubate.sparse.sparse_coo_tensor	2
torch.zeros_like	paddle.zeros_like	2
torch.ones_like	paddle.ones_like	2
torch.range	paddle.arange	2
torch.arange	paddle.arange	2
torch.linspace	paddle.linspace	2
torch.logspace	paddle.logspace	2
torch.eye	paddle.eye	2
torch.empty	paddle.empty	2
torch.empty_like	paddle.empty_like	2
torch.full	paddle.full	2
torch.full_like	paddle.full_like	2
torch.complex	paddle.complex	2
torch.abs	paddle.abs	2
torch.angle	paddle.angle	2
torch.heaviside	paddle.heaviside	2
torch.cat	paddle.concat	2
torch.dstack	paddle.stack	2
torch.gather	paddle.take_along_axis	2
torch.index_select	paddle.index_select	2
torch.masked_select	paddle.masked_select	2
torch.nonzero	paddle.nonzero	2
torch.scatter	paddle.put_along_axis	2
torch.Tensor.scatter_	paddle.Tensor.put_along_axis_	2
torch.scatter_add	paddle.put_along_axis	2
torch.Tensor.scatter_add_	paddle.Tensor.put_along_axis_	2
torch.stack	paddle.stack	2
torch.bernoulli	paddle.bernoulli	2
torch.multinomial	paddle.multinomial	2
torch.normal	paddle.normal	2
torch.poisson	paddle.poisson	2
torch.randint	paddle.randint	2
torch.randint_like	paddle.randint_like	2
torch.randperm	paddle.randperm	2
torch.load	paddle.load	2
torch.absolute	paddle.abs	2
torch.acos	paddle.acos	2
torch.arccos	paddle.acos	2
torch.acosh	paddle.acosh	2
torch.arccosh	paddle.acosh	2
torch.add	paddle.add	2
torch.asin	paddle.asin	2
torch.arcsin	paddle.asin	2
torch.asinh	paddle.asinh	2
torch.arcsinh	paddle.asinh	2
torch.atan	paddle.atan	2
torch.arctan	paddle.atan	2
torch.atanh	paddle.atanh	2
torch.arctanh	paddle.atanh	2
torch.atan2	paddle.atan2	2
torch.bitwise_not	paddle.bitwise_not	2
torch.bitwise_and	paddle.bitwise_and	2
torch.bitwise_or	paddle.bitwise_or	2
torch.bitwise_xor	paddle.bitwise_xor	2
torch.ceil	paddle.ceil	2
torch.clamp	paddle.clip	2
torch.clip	paddle.clip	2
torch.cos	paddle.cos	2
torch.cosh	paddle.cosh	2
torch.deg2rad	paddle.deg2rad	2
torch.div	paddle.divide	2
torch.divide	paddle.divide	2
torch.digamma	paddle.digamma	2
torch.erf	paddle.erf	2
torch.erfinv	paddle.erfinv	2
torch.exp	paddle.exp	2
torch.expm1	paddle.expm1	2
torch.fix	paddle.trunc	2
torch.trunc	paddle.trunc	2
torch.floor	paddle.floor	2
torch.floor_divide	paddle.floor_divide	2
torch.frac	paddle.frac	2
torch.lerp	paddle.lerp	2
torch.lgamma	paddle.lgamma	2
torch.log	paddle.log	2
torch.log10	paddle.log10	2
torch.log1p	paddle.log1p	2
torch.log2	paddle.log2	2
torch.logical_and	paddle.logical_and	2
torch.logical_not	paddle.logical_not	2
torch.logical_or	paddle.logical_or	2
torch.logical_xor	paddle.logical_xor	2
torch.logit	paddle.logit	2
torch.mul	paddle.multiply	2
torch.multiply	paddle.multiply	2
torch.nan_to_num	paddle.nan_to_num	2
torch.neg	paddle.neg	2
torch.negative	paddle.neg	2
torch.pow	paddle.pow	2
torch.rad2deg	paddle.rad2deg	2
torch.reciprocal	paddle.reciprocal	2
torch.round	paddle.round	2
torch.rsqrt	paddle.rsqrt	2
torch.sigmoid	paddle.nn.functional.sigmoid	2
torch.sign	paddle.sign	2
torch.sgn	paddle.sgn	2
torch.sin	paddle.sin	2
torch.sinh	paddle.sinh	2
torch.sqrt	paddle.sqrt	2
torch.square	paddle.square	2
torch.sub	paddle.subtract	2
torch.subtract	paddle.subtract	2
torch.tan	paddle.tan	2
torch.tanh	paddle.tanh	2
torch.true_divide	paddle.divide	2
torch.amax	paddle.amax	2
torch.amin	paddle.amin	2
torch.logsumexp	paddle.logsumexp	2
torch.mean	paddle.mean	2
torch.mode	paddle.mode	2
torch.norm	paddle.linalg.norm	2
torch.quantile	paddle.quantile	2
torch.nanquantile	paddle.nanquantile	2
torch.std	paddle.std	2
torch.unique	paddle.unique	2
torch.var	paddle.var	2
torch.argsort	paddle.argsort	2
torch.eq	paddle.equal	2
torch.ge	paddle.greater_equal	2
torch.greater_equal	paddle.greater_equal	2
torch.gt	paddle.greater_than	2
torch.greater	paddle.greater_than	2
torch.kthvalue	paddle.kthvalue	2
torch.le	paddle.less_equal	2
torch.less_equal	paddle.less_equal	2
torch.lt	paddle.less_than	2
torch.less	paddle.less_than	2
torch.maximum	paddle.maximum	2
torch.minimum	paddle.minimum	2
torch.fmax	paddle.fmax	2
torch.fmin	paddle.fmin	2
torch.ne	paddle.not_equal	2
torch.not_equal	paddle.not_equal	2
torch.sort	paddle.sort	2
torch.topk	paddle.topk	2
torch.stft	paddle.signal.stft	2
torch.bucketize	paddle.buckezite	2
torch.clone	paddle.clone	2
torch.cross	paddle.cross	2
torch.cumprod	paddle.cumprod	2
torch.cumsum	paddle.cumsum	2
torch.diag	paddle.diag	2
torch.kron	paddle.kron	2
torch.gcd	paddle.gcd	2
torch.histc	paddle.histogram	2
torch.meshgrid	paddle.meshgrid	2
torch.lcm	paddle.lcm	2
torch.logcumsumexp	paddle.logcumsumexp	2
torch.renorm	paddle.renorm	2
torch.repeat_interleave	paddle.repeat_interleave	2
torch.searchsorted	paddle.searchsorted	2
torch.tensordot	paddle.tensordot	2
torch.tril	paddle.tril	2
torch.tril_indices	paddle.tril_indices	2
torch.triu	paddle.triu	2
torch.triu_indices	paddle.triu_indices	2
torch.addmm	paddle.addmm	2
torch.bmm	paddle.bmm	2
torch.linalg.cholesky	paddle.linalg.cholesky	2
torch.cholesky	paddle.linalg.cholesky	2
torch.cholesky_solve	paddle.linalg.cholesky_solve	2
torch.dot	paddle.dot	2
torch.ger	paddle.outer	2
torch.outer	paddle.outer	2
torch.inner	paddle.inner	2
torch.inverse	paddle.linalg.inv	2
torch.lu	paddle.linalg.lu	2
torch.lu_unpack	paddle.linalg.lu_unpack	2
torch.matmul	paddle.matmul	2
torch.matrix_power	paddle.linalg.matrix_power	2
torch.linalg.matrix_rank	paddle.linalg.matrix_rank	2
torch.mm	paddle.mm	2
torch.mv	paddle.mv	2
torch.qr	paddle.linalg.qr	2
torch.svd	paddle.linalg.svd	2
torch.svd_lowrank	paddle.linalg.svd	2
torch.symeig	paddle.linalg.eigh	2
torch.nn.Conv1d	paddle.nn.Conv1D	2
torch.nn.Conv2d	paddle.nn.Conv2D	2
torch.nn.Conv3d	paddle.nn.Conv3D	2
torch.nn.ConvTranspose1d	paddle.nn.Conv1DTranspose	2
torch.nn.ConvTranspose2d	paddle.nn.Conv2DTranspose	2
torch.nn.ConvTranspose3d	paddle.nn.Conv3DTranspose	2
torch.nn.MaxPool1d	paddle.nn.MaxPool1D	2
torch.nn.MaxPool2d	paddle.nn.MaxPool2D	2
torch.nn.MaxPool3d	paddle.nn.MaxPool3D	2
torch.nn.ELU	paddle.nn.ELU	2
torch.nn.Hardsigmoid	paddle.nn.Hardsigmoid	2
torch.nn.Hardtanh	paddle.nn.Hardtanh	2
torch.nn.Hardswish	paddle.nn.Hardswish	2
torch.nn.LeakyReLU	paddle.nn.LeakyReLU	2
torch.nn.MultiheadAttention	paddle.nn.MultiHeadAttention	2
torch.nn.PReLU	paddle.nn.PReLU	2
torch.nn.ReLU	paddle.nn.ReLU	2
torch.nn.ReLU6	paddle.nn.ReLU6	2
torch.nn.RReLU	paddle.nn.RReLU	2
torch.nn.SELU	paddle.nn.SELU	2
torch.nn.CELU	paddle.nn.CELU	2
torch.nn.SiLU	paddle.nn.Silu	2
torch.nn.Threshold	paddle.nn.ThresholdedReLU	2
torch.nn.GroupNorm	paddle.nn.GroupNorm	2
torch.nn.LayerNorm	paddle.nn.LayerNorm	2
torch.nn.RNNBase	paddle.nn.RNNCellBase	2
torch.nn.RNN	paddle.nn.RNN	2
torch.nn.LSTM	paddle.nn.LSTM	2
torch.nn.GRU	paddle.nn.GRU	2
torch.nn.LSTMCell	paddle.nn.LSTMCell	2
torch.nn.GRUCell	paddle.nn.GRUCell	2
torch.nn.Transformer	paddle.nn.Transformer	2
torch.nn.TransformerEncoder	paddle.nn.TransformerEncoder	2
torch.nn.TransformerEncoderLayer	paddle.nn.TransformerEncoderLayer	2
torch.nn.TransformerDecoderLayer	paddle.nn.TransformerDecoderLayer	2
torch.nn.Linear	paddle.nn.Linear	2
torch.nn.Bilinear	paddle.nn.Bilinear	2
torch.nn.Dropout	paddle.nn.Dropout	2
torch.nn.Dropout2d	paddle.nn.Dropout2D	2
torch.nn.Dropout3d	paddle.nn.Dropout3D	2
torch.nn.AlphaDropout	paddle.nn.AlphaDropout	2
torch.nn.Embedding	paddle.nn.Embedding	2
torch.nn.L1Loss	paddle.nn.L1Loss	2
torch.nn.MSELoss	paddle.nn.MSELoss	2
torch.nn.CrossEntropyLoss	paddle.nn.CrossEntropyLoss	2
torch.nn.NLLLoss	paddle.nn.NLLLoss	2
torch.nn.CTCLoss	paddle.nn.CTCLoss	2
torch.nn.KLDivLoss	paddle.nn.KLDivLoss	2
torch.nn.BCELoss	paddle.nn.BCELoss	2
torch.nn.BCEWithLogitsLoss	paddle.nn.BCEWithLogitsLoss	2
torch.nn.MarginRankingLoss	paddle.nn.MarginRankingLoss	2
torch.nn.HingeEmbeddingLoss	paddle.nn.HingeEmbeddingLoss	2
torch.nn.SmoothL1Loss	paddle.nn.SmoothL1Loss	2
torch.nn.SoftMarginLoss	paddle.nn.SoftMarginLoss	2
torch.nn.MultiLabelSoftMarginLoss	paddle.nn.MultiLabelSoftMarginLoss	2
torch.nn.CosineEmbeddingLoss	paddle.nn.CosineEmbeddingLoss	2
torch.nn.TripletMarginLoss	paddle.nn.TripletMarginLoss	2
torch.nn.Upsample	paddle.nn.Upsample	2
torch.nn.parallel.DistributedDataParallel	paddle.DataParallel	2
torch.nn.functional.max_pool1d	paddle.nn.functional.max_pool1d	2
torch.nn.functional.max_pool2d	paddle.nn.functional.max_pool2d	2
torch.nn.functional.max_pool3d	paddle.nn.functional.max_pool3d	2
torch.nn.functional.threshold	paddle.nn.functional.thresholded_relu	2
torch.nn.functional.relu	paddle.nn.functional.relu	2
torch.nn.functional.hardtanh	paddle.nn.functional.hardtanh	2
torch.nn.functional.hardswish	paddle.nn.functional.hardswish	2
torch.nn.functional.elu	paddle.nn.functional.elu	2
torch.nn.functional.selu	paddle.nn.functional.selu	2
torch.nn.functional.celu	paddle.nn.functional.celu	2
torch.nn.functional.leaky_relu	paddle.nn.functional.leaky_relu	2
torch.nn.functional.rrelu	paddle.nn.functional.rrelu	2
torch.nn.functional.gumbel_softmax	paddle.nn.functional.gumbel_softmax	2
torch.nn.functional.log_softmax	paddle.nn.functional.log_softmax	2
torch.nn.functional.tanh	paddle.nn.functional.tanh	2
torch.nn.functional.hardsigmoid	paddle.nn.functional.hardsigmoid	2
torch.nn.functional.silu	paddle.nn.functional.silu	2
torch.nn.functional.normalize	paddle.nn.functional.normalize	2
torch.nn.functional.dropout	paddle.nn.functional.dropout	2
torch.nn.functional.alpha_dropout	paddle.nn.functional.alpha_dropout	2
torch.nn.functional.dropout2d	paddle.nn.functional.dropout2d	2
torch.nn.functional.dropout3d	paddle.nn.functional.dropout3d	2
torch.nn.functional.embedding	paddle.nn.functional.embedding	2
torch.nn.functional.binary_cross_entropy	paddle.nn.functional.binary_cross_entropy	2
torch.nn.functional.binary_cross_entropy_with_logits	paddle.nn.functional.binary_cross_entropy_with_logits	2
torch.nn.functional.cosine_embedding_loss	paddle.nn.functional.cosine_embedding_loss	2
torch.nn.functional.ctc_loss	paddle.nn.functional.ctc_loss	2
torch.nn.functional.hinge_embedding_loss	paddle.nn.functional.hinge_embedding_loss	2
torch.nn.functional.kl_div	paddle.nn.functional.kl_div	2
torch.nn.functional.l1_loss	paddle.nn.functional.l1_loss	2
torch.nn.functional.mse_loss	paddle.nn.functional.mse_loss	2
torch.nn.functional.interpolate	paddle.nn.functional.interpolate	2
torch.Tensor.add	paddle.Tensor.add	2
torch.Tensor.add_	paddle.Tensor.add_	2
torch.Tensor.backward	paddle.Tensor.backward	2
torch.Tensor.bernoulli	paddle.bernoulli(x)	2
torch.Tensor.bfloat16	paddle.Tensor.astype('bfloat16')	2
torch.Tensor.bool	paddle.Tensor.astype('bool')	2
torch.Tensor.byte	paddle.Tensor.astype('uint8')	2
torch.Tensor.char	paddle.Tensor.astype('int8')	2
torch.Tensor.clone	paddle.clone	2
torch.Tensor.copy_	paddle.assign	2
torch.Tensor.div	paddle.Tensor.divide	2
torch.Tensor.divide	paddle.Tensor.divide	2
torch.Tensor.double	paddle.Tensor.astype('float64')	2
torch.Tensor.eig	paddle.linalg.eig	2
torch.Tensor.exponential_	paddle.Tensor.exponential_	2
torch.Tensor.float	paddle.Tensor.astype('float32')	2
torch.Tensor.half	paddle.Tensor.astype('float16')	2
torch.Tensor.int	paddle.Tensor.astype('int32')	2
torch.Tensor.long	paddle.Tensor.astype('int64')	2
torch.Tensor.multinomial	paddle.multinomial	2
torch.Tensor.nan_to_num	paddle.Tensor.nan_to_num	2
torch.Tensor.norm	paddle.Tensor.norm	2
torch.Tensor.qr	paddle.Tensor.qr	2
torch.Tensor.quantile	paddle.Tensor.quantile	2
torch.Tensor.repeat_interleave	paddle.Tensor.repeat_interleave	2
torch.Tensor.round	paddle.Tensor.round	2
torch.Tensor.round_	paddle.Tensor.round_	2
torch.Tensor.scatter	paddle.Tensor.put_along_axis	2
torch.Tensor.scatter_add	paddle.Tensor.put_along_axis	2
torch.Tensor.short	paddle.Tensor.astype('int16')	2
torch.Tensor.size	paddle.Tensor.shape	2
torch.Tensor.stft	paddle.signal.stft	2
torch.Tensor.sub	paddle.Tensor.bsubtract	2
torch.Tensor.subtract	paddle.Tensor.subtract	2
torch.Tensor.subtract_	paddle.Tensor.subtract_	2
torch.Tensor.symeig	paddle.linalg.eigh	2
torch.Tensor.to	paddle.Tensor.cast	2
torch.Tensor.triangular_solve	paddle.Tensor.triangular_solve	2
torch.Tensor.type	paddle.Tensor.astype	2
torch.Tensor.unique	paddle.Tensor.unique	2
torch.autograd.backward	paddle.autograd.backward	2
torch.autograd.grad	paddle.grad	2
torch.autograd.functional.jacobian	paddle.incubate.autograd.Jacobian	2
torch.autograd.functional.hessian	paddle.incubate.autograd.Hessian	2
torch.autograd.functional.vjp	paddle.incubate.autograd.vjp	2
torch.autograd.functional.jvp	paddle.incubate.autograd.jvp	2
torch.cuda.Stream	paddle.device.cuda.Stream	2
torch.cuda.comm.broadcast	paddle.distributed.broadcast	2
torch.cuda.amp.autocast	paddle.amp.auto_cast	2
torch.cuda.amp.GradScaler	paddle.amp.GradScaler	2
torch.distributed.get_rank	paddle.distributed.get_rank	2
torch.distributed.get_world_size	paddle.distributed.get_world_size	2
torch.distributed.new_group	paddle.distributed.new_group	2
torch.distributed.send	paddle.distributed.send	2
torch.distributed.recv	paddle.distributed.recv	2
torch.distributed.broadcast	paddle.distributed.broadcast	2
torch.distributed.all_reduce	paddle.distributed.all_reduce	2
torch.distributed.reduce	paddle.distributed.reduce	2
torch.distributed.all_gather	paddle.distributed.all_gather	2
torch.distributed.scatter	paddle.distributed.scatter	2
torch.distributed.all_to_all	paddle.distributed.alltoall	2
torch.distributed.barrier	paddle.distributed.barrier	2
torch.distributions.distribution.Distribution	paddle.distribution.Distribution	2
torch.distributions.exp_family.ExponentialFamily	paddle.distribution.ExponentialFamily	2
torch.distributions.beta.Beta	paddle.distribution.Beta	2
torch.distributions.categorical.Categorical	paddle.distribution.Categorical	2
torch.distributions.dirichlet.Dirichlet	paddle.distribution.Dirichlet	2
torch.distributions.independent.Independent	paddle.distribution.Independent	2
torch.distributions.multinomial.Multinomial	paddle.distribution.Multinomial	2
torch.distributions.normal.Normal	paddle.distribution.Normal	2
torch.distributions.uniform.Uniform	paddle.distribution.Uniform	2
torch.distributions.transforms.IndependentTransform	paddle.distribution.IndependentTransform	2
torch.distributions.transforms.ReshapeTransform	paddle.distribution.ReshapeTransform	2
torch.distributions.transforms.ExpTransform	paddle.distribution.ExpTransform	2
torch.distributions.transforms.PowerTransform	paddle.distribution.PowerTransform	2
torch.distributions.transforms.SigmoidTransform	paddle.distribution.SigmoidTransform	2
torch.distributions.transforms.TanhTransform	paddle.distribution.TanhTransform	2
torch.distributions.transforms.AbsTransform	paddle.distribution.AbsTransform	2
torch.distributions.transforms.AffineTransform	paddle.distribution.AffineTransform	2
torch.distributions.transforms.SoftmaxTransform	paddle.distribution.SoftmaxTransform	2
torch.distributions.transforms.StickBreakingTransform	paddle.distribution.StickBreakingTransform	2
torch.distributions.transforms.StackTransform	paddle.distribution.StackTransform	2
torch.fft.fft	paddle.fft.fft	2
torch.fft.ifft	paddle.fft.ifft	2
torch.fft.fft2	paddle.fft.fft2	2
torch.fft.ifft2	paddle.fft.ifft2	2
torch.fft.fftn	paddle.fft.fftn	2
torch.fft.ifftn	paddle.fft.ifftn	2
torch.fft.rfft	paddle.fft.rfft	2
torch.fft.irfft	paddle.fft.irfft	2
torch.fft.rfft2	paddle.fft.rfft2	2
torch.fft.irfft2	paddle.fft.irfft2	2
torch.fft.rfftn	paddle.fft.rfftn	2
torch.fft.irfftn	paddle.fft.irfftn	2
torch.fft.hfft	paddle.fft.hfft	2
torch.fft.ihfft	paddle.fft.ihfft	2
torch.fft.fftfreq	paddle.fft.fftfreq	2
torch.fft.rfftfreq	paddle.fft.rfftfreq	2
torch.hub.list	paddle.hub.list	2
torch.hub.help	paddle.hub.help	2
torch.hub.load	paddle.hub.load	2
torch.hub.download_url_to_file	paddle.utils.download.get_weights_path_from_url	2
torch.jit.save	paddle.jit.save	2
torch.linalg.cond	paddle.linalg.cond	2
torch.linalg.det	paddle.linalg.det	2
torch.linalg.slogdet	paddle.linalg.slogdet	2
torch.linalg.eigh	paddle.linalg.eigh	2
torch.linalg.eigvalsh	paddle.linalg.eigvalsh	2
torch.linalg.norm	paddle.linalg.norm	2
torch.linalg.pinv	paddle.linalg.pinv	2
torch.linalg.solve	paddle.linalg.solve	2
torch.linalg.inv	paddle.linalg.inv	2
torch.linalg.qr	paddle.linalg.qr	2
torch.take_along_dim	paddle.take_along_axis	2
torch.nn.Mish	paddle.nn.Mish	2
torch.linalg.multi_dot	paddle.linalg.multi_dot	2
torch.nn.functional.mish	paddle.nn.functional.mish	2
torch.special.erf	paddle.erf	2
torch.linalg.eigvals	paddle.linalg.eigvals	2
torch.frexp	paddle.frexp	2
torch.linalg.eig	paddle.linalg.eig	2
torch.Tensor.nanmean	paddle.Tensor.nanmean	2
torch.nanmean	paddle.nanmean	2
torch.concat	paddle.concat	2
torch.special.log_softmax	paddle.nn.functional.log_softmax	2
torch.linalg.matmul	paddle.matmul	2
torch.special.log1p	paddle.log1p	2
torch.Tensor.histogram	paddle.Tensor.histogram	2
torch.special.round	paddle.round	2
torch.special.logsumexp	paddle.logsumexp	2
torch.special.digamma	paddle.digamma	2
torch.special.psi	paddle.digamma	2
torch.arctan2	paddle.atan2	2
torch.Tensor.arctan2	paddle.atan2	2
torch.fft.hfft2	paddle.fft.hfft2	2
torch.fft.ihfft2	paddle.fft.ihfft2	2
torch.fft.hfftn	paddle.fft.hfftn	2
torch.fft.ihfftn	paddle.fft.ihfftn	2
torch.linalg.solve_triangular	paddle.linalg.triangular_solve	2
torch.linalg.cross	paddle.cross	2
torch.Tensor.cfloat	paddle.Tensor.astype('complex64')	2
torch.Tensor.cdouble	paddle.Tensor.astype('complex128')	2
torch.linalg.lu	paddle.linalg.lu	2
torch.triangular_solve	paddle.linalg.triangular_solve	2
torch.optim.Optimizer.step	paddle.optimizer.Optimizer.step	2
torch.tensor	paddle.to_tensor	3
torch.zeros	paddle.zeros	3
torch.ones	paddle.ones	3
torch.narrow	paddle.slice	3
torch.split	paddle.split	3
torch.swapaxes	paddle.transpose	3
torch.transpose	paddle.transpose	3
torch.swapdims	paddle.transpose	3
torch.Generator	paddle.fluid.core.Generator	3
torch.get_rng_state	paddle.get_cuda_rng_state	3
torch.set_rng_state	paddle.set_cuda_rng_state	3
torch.rand	paddle.rand	3
torch.randn	paddle.randn	3
torch.save	paddle.save	3
torch.min	paddle.min	3
torch.max	paddle.max	3
torch.fmod	paddle.mod	3
torch.remainder	paddle.remainder	3
torch.equal	paddle.equal_all	3
torch.broadcast_tensors	paddle.broadcast_tensors	3
torch.broadcast_shapes	paddle.broadcast_shape	3
torch.einsum	paddle.einsum	3
torch.nn.Sequential	paddle.nn.Sequential	3
torch.nn.Unfold	paddle.nn.Unfold	3
torch.nn.AvgPool1d	paddle.nn.AvgPool1D	3
torch.nn.AvgPool2d	paddle.nn.AvgPool2D	3
torch.nn.AvgPool3d	paddle.nn.AvgPool3D	3
torch.nn.ReflectionPad1d	paddle.nn.Pad1D	3
torch.nn.ReflectionPad2d	paddle.nn.Pad2D	3
torch.nn.ReplicationPad1d	paddle.nn.Pad1D	3
torch.nn.ReplicationPad2d	paddle.nn.Pad2D	3
torch.nn.ReplicationPad3d	paddle.nn.Pad3D	3
torch.nn.ConstantPad1d	paddle.nn.Pad1D	3
torch.nn.ConstantPad2d	paddle.nn.Pad2D	3
torch.nn.ConstantPad3d	paddle.nn.Pad3D	3
torch.nn.GELU	paddle.nn.GELU	3
torch.nn.BatchNorm1d	paddle.nn.BatchNorm1D	3
torch.nn.BatchNorm2d	paddle.nn.BatchNorm2D	3
torch.nn.BatchNorm3d	paddle.nn.BatchNorm3D	3
torch.nn.SyncBatchNorm	paddle.nn.SyncBatchNorm	3
torch.nn.InstanceNorm1d	paddle.nn.InstanceNorm1D	3
torch.nn.InstanceNorm2d	paddle.nn.InstanceNorm2D	3
torch.nn.InstanceNorm3d	paddle.nn.InstanceNorm3D	3
torch.nn.RNNCell	paddle.nn.SimpleRNNCell	3
torch.nn.DataParallel		3
torch.nn.functional.unfold	paddle.nn.functional.unfold	3
torch.nn.functional.avg_pool1d	paddle.nn.functional.avg_pool1d	3
torch.nn.functional.avg_pool2d	paddle.nn.functional.avg_pool2d	3
torch.nn.functional.avg_pool3d	paddle.nn.functional.avg_pool3d	3
torch.nn.functional.gelu	paddle.nn.functional.gelu	3
torch.nn.functional.batch_norm	paddle.nn.functional.batch_norm	3
torch.nn.functional.instance_norm	paddle.nn.functional.instance_norm	3
torch.Tensor.cuda	paddle.Tensor.cuda	3
torch.Tensor.expand	paddle.Tensor.expand	3
torch.Tensor.fmod	paddle.Tensor.mod	3
torch.Tensor.index_add_	paddle.Tensor.index_add	3
torch.Tensor.narrow	paddle.Tensor.slice	3
torch.Tensor.narrow_copy	paddle.Tensor.slice	3
torch.Tensor.permute	paddle.Tensor.transpose	3
torch.Tensor.repeat	paddle.Tensor.tile	3
torch.Tensor.reshape	paddle.Tensor.reshape	3
torch.Tensor.split	paddle.Tensor.split	3
torch.Tensor.svd	paddle.linalg.svd	3
torch.Tensor.swapaxes	paddle.Tensor.transpose	3
torch.Tensor.swapdims	paddle.Tensor.transpose	3
torch.Tensor.transpose	paddle.Tensor.transpose	3
torch.cuda.device	paddle.CUDAPlace	3
torch.cuda.get_device_name	paddle.device.cuda.get_device_properties	3
torch.cuda.get_rng_state	paddle.get_cuda_rng_state	3
torch.cuda.get_rng_state_all	paddle.get_cuda_rng_state	3
torch.cuda.set_rng_state	paddle.set_cuda_rng_state	3
torch.cuda.set_rng_state_all	paddle.set_cuda_rng_state	3
torch.distributions.transforms.ComposeTransform	paddle.distribution.ChainTransform	3
torch.jit.load	paddle.jit.load	3
torch.profiler.profile	paddle.utils.profiler.profiler	3
torch.profiler.schedule	paddle.profiler.make_scheduler	3
torch.onnx.export	paddle.onnx.export	3
torch.random.get_rng_state	paddle.get_cuda_rng_state	3
torch.random.set_rng_state	paddle.set_cuda_rng_state	3
torch.utils.data.DataLoader	paddle.io.DataLoader	3
torch.utils.data.Dataset	paddle.io.Dataset	3
torch.utils.data.IterableDataset	paddle.io.IterableDataset	3
torch.utils.data.TensorDataset	paddle.io.TensorDataset	3
torch.utils.data.ConcatDataset	paddle.io.ComposeDataset	3
torch.utils.data.ChainDataset	paddle.io.ChainDataset	3
torch.utils.data.Subset	paddle.io.Subset	3
torch.utils.data.Sampler	paddle.io.Sampler	3
torch.utils.data.SequentialSampler	paddle.io.SequenceSampler	3
torch.utils.data.RandomSampler	paddle.io.RandomSampler	3
torch.utils.data.WeightedRandomSampler	paddle.io.WeightedRandomSampler	3
torch.utils.data.BatchSampler	paddle.io.BatchSampler	3
torch.utils.data.distributed.DistributedSampler	paddle.io.DistributedBatchSampler	3
torch.utils.data.get_worker_info	paddle.io.get_worker_info	3
torch.linalg.svdvals	paddle.linalg.svd	3
torch.autograd.profiler.profile.export_chrome_trace	paddle.profiler.export_chrome_tracing	3
torch.sparse_csr_tensor	paddle.incubate.sparse.sparse_csr_tensor	3
torch.histogram	paddle.histogram	3
torch.index_add	paddle.index_add	3
torch.optim.Optimizer.zero_grad	paddle.optimizer.Optimizer.clear_grad	3
torch.nn.Module.zero_grad	paddle.nn.Layer.clear_grad	3
torch.is_nonzero		4
torch.polar		4
torch.column_stack		4
torch.hstack		4
torch.row_stack		4
torch.vstack		4
torch.seed		4
torch.rand_like		4
torch.randn_like		4
torch.addcdiv		4
torch.addcmul		4
torch.copysign		4
torch.erfc		4
torch.exp2		4
torch.ldexp		4
torch.logaddexp		4
torch.logaddexp2		4
torch.xlogy		4
torch.std_mean		4
torch.var_mean		4
torch.block_diag		4
torch.cdist		4
torch.cummax		4
torch.cummin		4
torch.vander		4
torch.addbmm		4
torch.addmv		4
torch.addr		4
torch.baddbmm		4
torch.chain_matmul		4
torch.cholesky_inverse		4
torch.logdet		4
torch._assert		4
torch.nn.parameter.Parameter		4
torch.nn.LazyConv1d		4
torch.nn.LazyConv2d		4
torch.nn.LazyConv3d		4
torch.nn.LazyConvTranspose1d		4
torch.nn.LazyConvTranspose2d		4
torch.nn.LazyConvTranspose3d		4
torch.nn.Softmin		4
torch.nn.Softmax2d		4
torch.nn.AdaptiveLogSoftmaxWithLoss		4
torch.nn.LazyLinear		4
torch.nn.PoissonNLLLoss		4
torch.nn.GaussianNLLLoss		4
torch.nn.MultiLabelMarginLoss		4
torch.nn.functional.softmin		4
torch.nn.functional.layer_norm		4
torch.nn.functional.upsample_nearest		4
torch.nn.functional.upsample_bilinear		4
torch.Tensor.is_cuda		4
torch.Tensor.requires_grad		4
torch.Tensor.new_tensor		4
torch.Tensor.new_full	paddle.full()	4
torch.Tensor.new_empty	paddle.empty()	4
torch.Tensor.new_ones	paddle.ones()	4
torch.Tensor.new_zeros	paddle.empty	4
torch.Tensor.addbmm		4
torch.Tensor.addcdiv		4
torch.Tensor.addcmul		4
torch.Tensor.addmv		4
torch.Tensor.addr		4
torch.Tensor.baddbmm		4
torch.Tensor.bernoulli_	paddle.bernoulli(x)	4
torch.Tensor.cholesky_inverse		4
torch.Tensor.copysign		4
torch.Tensor.cummax		4
torch.Tensor.cummin		4
torch.Tensor.dequantize		4
torch.Tensor.diag_embed	paddle.nn.functional.diag_embed	4
torch.Tensor.erfc		4
torch.Tensor.expm1	paddle.expm1	4
torch.Tensor.index_fill		4
torch.Tensor.index_put		4
torch.Tensor.ldexp		4
torch.Tensor.logaddexp		4
torch.Tensor.logaddexp2		4
torch.Tensor.map_		4
torch.Tensor.masked_scatter		4
torch.Tensor.masked_fill		4
torch.Tensor.msort		4
torch.Tensor.pinverse	paddle.linalg.pinv	4
torch.Tensor.ravel		4
torch.Tensor.requires_grad_		4
torch.Tensor.reshape_as	paddle.Tensor.reshape(y.shape)	4
torch.Tensor.resize_		4
torch.Tensor.resize_as_		4
torch.Tensor.tensor_split		4
torch.Tensor.type_as	paddle.Tensor.astype(x.dtype)	4
torch.Tensor.unfold		4
torch.Tensor.vdot		4
torch.Tensor.xlogy		4
torch.device		4
torch.autograd.profiler.profile		4
torch.distributed.init_process_group	paddle.distributed.init_parallel_env	4
torch.distributions.constraints.Constraint		4
torch.distributions.constraint_registry.ConstraintRegistry		4
torch.linalg.tensorinv		4
torch.linalg.tensorsolve		4
torch.utils.cpp_extension.load_inline		4
torch.linalg.inv_ex		4
torch.nn.LazyBatchNorm1d		4
torch.nn.functional.group_norm		4
torch.linalg.cholesky_ex		4
torch.nn.LazyBatchNorm2d		4
torch.special.xlog1py		4
torch.nn.LazyBatchNorm3d		4
torch.Tensor.aminmax	paddle.Tensor.amin	4
torch.aminmax	paddle.amin	4
torch.nn.LazyInstanceNorm2d		4
torch.nn.LazyInstanceNorm1d		4
torch.nn.GLU	paddle.nn.functional.glu	4
torch.Tensor.unflatten		4
torch.adjoint		4
torch.diagonal_scatter		4
torch.select_scatter		4
torch.slice_scatter		4
torch.scatter_reduce		4
torch.Tensor.scatter_reduce		4
torch.Tensor.select_scatter		4
torch.Tensor.slice_scatter		4
torch.nn.utils.stateless.functional_call		4
torch.nn.init.trunc_normal_		4
torch.Tensor.index_copy_		4
